
NO ./textures/north.xpm
SO ./textures/south.xpm
   WE    ./textures/west.xpm
EA     ./textures/east.xpm 

F 80,80,80
C 225,30,0

        1111111111111111111111111
        1000000000110000000000001
        10110000011100D0000000001
        1001000000000000000000001
111111111011000001110000000000001
10000000001100000111011111D111111
11110111111111011100000010001
11110111111111011101010010001
110000001101010111000000D0F01
10000000000000001100000010001
10000000000000001101010010N01
11000001110101011111011111D11
11110111 1110101 101111010001
11111111 1111111 111111111111