11111111111111111111111111111
10000000000000000000000000001
10100000000000011000000000011
11000000000000000000000000001
11000000000000000001100000001
11000110000000N00000000000001
11000000000000000001000000001
11000000000000000000000000001
11000000000111110000000000001
11000000000000000000000000001
11111111111111111111111111111
