11111111111111111111
10011111111111111101
10100000000000000001
11000000000000000001
11000010010000000001
11001000000000000001
11000001000100000001
11000000000000000001
11001010000N00000001
11000000010000000001
11000000000000000001
11000010000000000001
11111111111111111111
